//MAP CONVERTED BY dmm2tgm.py THIS HEADER COMMENT PREVENTS RECONVERSION, DO NOT REMOVE
"a" = (
/turf/open/space/basic,
/area/space)
"c" = (
/obj/effect/turf_decal/vg_decals/numbers/two,
/turf/open/floor/engine,
/area/space)
"e" = (
/obj/structure/fluff/metalpole{
	dir = 10
	},
/turf/open/space/basic,
/area/space)
"j" = (
/obj/structure/window/reinforced/survival_pod{
	dir = 1
	},
/obj/structure/fluff/metalpole{
	dir = 1
	},
/obj/structure/fluff/metalpole,
/turf/open/space/basic,
/area/space)
"k" = (
/turf/open/floor/plating,
/area/space)
"l" = (
/obj/structure/lattice/catwalk,
/obj/structure/lattice,
/turf/open/space/basic,
/area/space)
"m" = (
/obj/effect/turf_decal/vg_decals/numbers/six,
/turf/open/floor/engine,
/area/space)
"p" = (
/obj/effect/spawner/structure/window/reinforced/shuttle,
/turf/open/space/basic,
/area/space)
"r" = (
/obj/structure/window/reinforced/survival_pod,
/obj/structure/fluff/metalpole{
	dir = 1
	},
/obj/structure/fluff/metalpole,
/turf/open/space/basic,
/area/space)
"w" = (
/obj/machinery/light/floor,
/turf/open/floor/engine,
/area/space)
"y" = (
/obj/structure/fluff/metalpole{
	dir = 4
	},
/obj/structure/fluff/metalpole{
	dir = 8
	},
/turf/open/space/basic,
/area/space)
"z" = (
/obj/structure/window/reinforced/survival_pod{
	dir = 1
	},
/obj/structure/fluff/metalpole,
/obj/structure/fluff/metalpole{
	dir = 1
	},
/turf/open/space/basic,
/area/space)
"B" = (
/turf/closed/wall/mineral/titanium/interior,
/area/space)
"D" = (
/obj/effect/turf_decal/vg_decals/numbers/five,
/turf/open/floor/engine,
/area/space)
"E" = (
/obj/structure/fluff/metalpole{
	dir = 1
	},
/obj/structure/fluff/metalpole,
/turf/open/space/basic,
/area/space)
"F" = (
/obj/structure/lattice,
/turf/open/space/basic,
/area/space)
"H" = (
/obj/effect/turf_decal/vg_decals/numbers/one,
/turf/open/floor/engine,
/area/space)
"N" = (
/obj/effect/spawner/structure/window/reinforced/shuttle,
/turf/open/floor/plating,
/area/space)
"P" = (
/obj/effect/turf_decal/vg_decals/numbers/three,
/turf/open/floor/engine,
/area/space)
"R" = (
/obj/structure/fluff/metalpole{
	dir = 6
	},
/turf/open/space/basic,
/area/space)
"T" = (
/turf/closed/wall/mineral/titanium,
/area/space)
"V" = (
/turf/open/floor/engine,
/area/space)
"X" = (
/obj/structure/window/reinforced/survival_pod,
/obj/structure/fluff/metalpole,
/obj/structure/fluff/metalpole{
	dir = 1
	},
/turf/open/space/basic,
/area/space)
"Z" = (
/turf/closed/wall/mineral/titanium/nodiagonal,
/area/space)

(1,1,1) = {"
a
a
a
a
a
a
a
a
a
a
a
a
a
a
a
a
a
a
a
a
a
a
a
a
a
a
a
a
a
a
a
a
a
a
a
a
a
a
a
a
a
T
a
a
a
T
a
a
a
a
a
a
a
a
a
a
a
a
a
a
a
"}
(2,1,1) = {"
a
a
a
a
a
a
a
a
a
a
a
a
a
a
a
a
a
a
a
a
a
a
a
a
a
a
a
a
a
a
a
a
a
a
a
a
a
a
a
a
T
Z
N
N
N
Z
T
a
a
a
a
a
a
a
a
a
a
a
a
a
a
"}
(3,1,1) = {"
a
a
a
a
a
a
a
a
a
a
a
a
a
a
a
a
a
a
a
a
a
a
a
a
a
a
a
a
a
a
a
T
T
a
a
a
a
a
a
a
a
N
V
V
V
N
a
a
a
a
a
a
a
a
T
T
a
a
a
a
a
"}
(4,1,1) = {"
a
a
a
a
a
a
a
a
a
a
a
a
a
a
a
a
a
a
a
a
a
a
a
a
a
a
a
a
a
a
a
T
Z
N
N
N
Z
R
R
R
R
N
V
w
V
N
R
R
R
R
Z
N
N
N
Z
T
a
a
a
a
a
"}
(5,1,1) = {"
a
a
a
a
a
a
a
a
a
a
a
a
a
a
a
a
a
a
a
a
a
a
a
a
a
a
a
a
a
a
a
a
N
V
V
V
N
a
a
a
a
N
V
V
P
N
a
a
a
a
N
V
V
V
N
a
a
a
a
a
a
"}
(6,1,1) = {"
a
a
a
a
a
a
a
a
a
a
a
a
a
a
a
a
a
a
a
a
a
a
a
a
a
a
a
a
a
a
a
a
N
V
w
V
N
R
R
R
T
Z
N
N
N
Z
T
R
R
R
N
V
w
V
N
a
a
a
a
a
a
"}
(7,1,1) = {"
a
a
a
a
a
a
a
a
a
a
a
a
a
a
a
a
a
a
a
a
a
a
a
a
a
a
a
a
a
a
a
a
N
V
V
c
N
a
a
a
a
T
a
E
a
T
a
a
a
a
N
V
V
D
N
a
a
a
a
a
a
"}
(8,1,1) = {"
a
a
a
a
a
a
a
a
a
a
a
a
a
a
a
a
a
a
a
a
a
a
a
a
a
a
a
a
a
a
a
a
Z
N
N
N
Z
T
a
a
a
l
a
E
a
l
a
a
a
T
Z
N
N
N
Z
a
a
a
a
a
a
"}
(9,1,1) = {"
a
a
a
a
a
a
a
a
a
a
a
a
a
a
a
a
a
a
a
a
a
a
a
a
a
a
a
a
a
a
a
a
e
a
e
a
T
T
F
a
a
l
a
E
a
l
a
a
F
T
T
a
e
a
e
a
a
a
a
a
a
"}
(10,1,1) = {"
a
a
a
a
a
a
a
a
a
a
a
a
a
a
a
a
a
a
a
a
a
a
a
a
a
a
a
a
a
a
a
a
e
a
e
a
a
F
F
F
a
T
N
N
N
T
a
F
F
F
a
a
e
a
e
a
a
a
a
a
a
"}
(11,1,1) = {"
a
a
a
a
a
a
a
a
a
a
a
a
a
a
a
a
a
a
a
a
a
a
a
a
a
a
a
a
a
a
a
a
e
a
e
a
a
a
F
T
T
T
k
k
k
T
T
T
F
a
a
a
e
a
e
a
a
a
a
a
a
"}
(12,1,1) = {"
a
a
a
a
a
a
a
a
a
a
a
a
a
a
a
a
a
a
a
a
a
a
a
a
a
a
a
a
a
a
T
a
e
a
T
a
a
a
a
T
k
k
k
k
k
k
k
T
a
a
a
a
T
a
e
a
T
a
a
a
a
"}
(13,1,1) = {"
a
a
a
a
a
a
a
a
a
a
a
a
a
a
a
a
a
a
a
a
a
a
a
a
a
a
a
a
a
T
Z
N
N
N
Z
T
l
l
T
T
k
k
k
k
k
k
k
T
T
l
l
T
Z
N
N
N
Z
T
a
a
a
"}
(14,1,1) = {"
a
a
a
a
a
a
a
a
a
a
a
a
a
a
a
a
a
a
a
a
a
a
a
a
a
a
a
a
a
a
N
V
V
V
N
a
a
a
N
k
k
k
k
k
k
k
k
k
N
a
a
a
N
V
V
V
N
a
a
a
a
"}
(15,1,1) = {"
a
a
a
a
a
a
a
a
a
a
a
a
a
a
a
a
a
a
a
a
a
a
a
a
a
a
a
a
a
a
N
V
w
V
N
y
y
y
N
k
k
k
k
k
k
k
k
k
N
y
y
y
N
V
w
V
N
a
a
a
a
"}
(16,1,1) = {"
a
a
a
a
a
a
a
a
a
a
a
a
a
a
a
a
a
a
a
a
a
a
a
a
a
a
a
a
a
a
N
V
V
H
N
a
a
a
N
k
k
k
k
k
k
k
k
k
N
a
a
a
N
V
V
m
N
a
a
a
a
"}
(17,1,1) = {"
a
a
a
a
a
a
a
a
a
a
a
a
a
a
a
a
a
a
a
a
a
a
a
a
a
a
a
a
a
T
Z
N
N
N
T
T
l
l
T
T
k
k
k
k
k
k
k
T
T
l
l
T
Z
N
N
N
Z
T
a
a
a
"}
(18,1,1) = {"
a
a
a
a
a
a
a
a
a
a
a
a
a
a
a
a
a
a
a
a
a
a
a
a
a
a
a
a
a
a
T
a
a
a
T
a
a
a
a
T
k
k
k
k
k
k
k
T
a
a
a
a
T
a
a
a
T
a
a
a
a
"}
(19,1,1) = {"
a
a
a
a
a
a
a
a
a
a
a
a
a
a
a
a
a
a
a
a
a
a
a
a
a
a
a
a
a
a
a
a
a
a
a
a
a
a
a
T
T
T
k
k
k
T
T
T
a
a
a
a
a
a
a
a
a
a
a
a
a
"}
(20,1,1) = {"
a
a
a
a
a
a
a
a
a
a
a
a
a
a
a
a
a
a
a
a
a
a
a
a
a
a
a
a
a
a
a
a
a
a
a
a
a
a
a
a
a
T
T
k
T
T
a
a
a
a
a
a
a
a
a
a
a
a
a
a
a
"}
(21,1,1) = {"
a
a
a
a
a
a
a
a
a
a
a
a
a
a
a
a
a
a
a
a
a
a
a
a
a
a
a
a
a
a
a
a
a
a
a
a
a
a
a
a
a
a
X
k
j
a
a
a
a
a
a
a
a
a
T
T
T
T
a
a
a
"}
(22,1,1) = {"
a
a
a
a
a
a
a
a
a
a
a
a
a
a
a
a
a
a
a
a
a
a
a
a
a
a
a
a
a
a
a
a
a
a
a
a
a
a
a
a
a
T
T
k
T
T
a
a
a
a
a
a
a
T
T
k
k
T
T
a
a
"}
(23,1,1) = {"
a
a
a
a
a
a
a
a
a
a
a
a
a
a
a
a
a
a
a
a
a
a
a
a
a
a
a
a
a
a
a
a
a
a
a
a
T
T
a
T
T
T
k
k
k
T
T
T
a
a
a
a
T
T
k
k
k
k
T
T
a
"}
(24,1,1) = {"
a
a
a
a
a
a
a
a
a
a
a
a
a
a
a
a
a
a
a
a
a
a
a
a
a
a
a
a
a
a
a
a
a
a
T
T
T
T
T
T
k
k
k
k
k
k
k
T
T
a
a
T
T
k
k
k
k
k
k
T
a
"}
(25,1,1) = {"
a
a
a
a
a
a
a
a
a
a
a
a
a
a
a
a
a
a
a
a
a
a
a
a
a
a
a
a
a
a
a
a
a
T
T
k
k
T
T
k
k
k
k
k
k
k
k
k
T
a
T
T
k
k
k
k
k
k
k
T
a
"}
(26,1,1) = {"
a
a
a
a
a
a
a
a
a
a
a
a
a
a
a
a
a
a
a
a
a
a
a
a
a
a
a
a
a
a
a
a
T
T
k
k
k
T
T
k
k
k
k
k
k
k
k
k
T
T
T
T
T
k
T
T
T
T
T
T
T
"}
(27,1,1) = {"
a
a
a
a
a
a
a
a
a
a
a
a
a
a
a
a
a
a
a
a
a
a
a
a
a
a
a
a
a
a
a
a
p
k
k
k
k
T
k
k
k
k
k
k
k
k
k
k
k
k
k
k
k
k
k
k
k
k
T
k
T
"}
(28,1,1) = {"
a
a
a
a
a
a
a
a
a
a
a
a
a
a
a
a
a
a
a
a
a
a
a
a
a
a
a
a
a
a
a
a
p
k
k
k
k
k
k
k
k
k
k
k
k
k
k
k
k
k
k
k
k
k
k
k
k
k
k
k
k
"}
(29,1,1) = {"
a
a
a
a
a
a
a
a
a
a
a
a
a
a
a
a
a
a
a
a
a
a
a
a
a
a
a
a
a
a
a
a
p
k
k
k
k
T
k
k
k
k
k
k
k
k
k
k
k
k
k
k
k
k
k
k
k
k
T
k
T
"}
(30,1,1) = {"
a
a
a
a
a
a
a
a
a
a
a
a
a
a
a
a
a
a
a
a
a
a
a
a
a
a
a
a
a
a
a
a
T
T
k
k
k
T
T
k
k
k
k
k
k
k
k
k
T
B
T
T
T
k
T
T
T
T
T
T
T
"}
(31,1,1) = {"
a
a
a
a
a
a
a
a
a
a
a
a
a
a
a
a
a
a
a
a
a
a
a
a
a
a
a
a
a
a
a
a
a
T
T
k
k
T
T
k
k
k
k
k
k
k
k
k
T
a
T
T
k
k
k
k
k
k
k
T
a
"}
(32,1,1) = {"
a
a
a
a
a
a
a
a
a
a
a
a
a
a
a
a
a
a
a
a
a
a
a
a
a
a
a
a
a
a
a
a
a
a
T
T
T
T
T
T
k
k
k
k
k
k
k
T
T
a
a
T
T
k
k
k
k
k
k
T
a
"}
(33,1,1) = {"
a
a
a
a
a
a
a
a
a
a
a
a
a
a
a
a
a
a
a
a
a
a
a
a
a
a
a
a
a
a
a
a
a
a
a
a
T
T
a
T
T
T
k
k
k
T
T
T
a
a
a
a
T
T
k
k
k
k
T
T
a
"}
(34,1,1) = {"
a
a
a
a
a
a
a
a
a
a
a
a
a
a
a
a
a
a
a
a
a
a
a
a
a
a
a
a
a
a
a
a
a
a
a
a
a
a
a
a
a
T
T
k
T
T
a
a
a
a
a
a
a
T
T
k
k
T
T
a
a
"}
(35,1,1) = {"
a
a
a
a
a
a
a
a
a
a
a
a
a
a
a
a
a
a
a
a
a
a
a
a
a
a
a
a
a
a
a
a
a
a
a
a
a
a
a
a
a
a
r
k
z
a
a
a
a
a
a
a
a
a
T
T
T
T
a
a
a
"}
(36,1,1) = {"
a
a
a
a
a
a
a
a
a
a
a
a
a
a
a
a
a
a
a
a
a
a
a
a
a
a
a
a
a
a
T
T
T
T
a
a
a
a
a
a
a
T
T
k
T
T
a
a
a
a
a
a
a
a
a
a
a
a
a
a
a
"}
(37,1,1) = {"
a
a
a
a
a
a
a
a
a
a
a
a
a
a
a
a
a
a
a
a
a
a
a
a
a
a
a
a
a
a
T
k
k
T
T
T
a
a
a
T
T
T
k
k
k
T
T
T
a
a
a
T
T
T
T
T
T
a
a
a
a
"}
(38,1,1) = {"
a
a
a
a
a
a
a
a
a
a
a
a
a
a
a
a
a
a
a
a
a
a
a
a
a
a
a
a
a
a
T
k
k
k
k
T
a
a
a
T
k
k
k
k
k
k
k
T
a
a
a
T
k
k
k
k
T
a
a
a
a
"}
(39,1,1) = {"
a
a
a
a
a
a
a
a
a
a
a
a
a
a
a
a
a
a
a
a
a
a
a
a
a
a
a
a
a
a
T
k
k
k
k
T
T
a
T
T
k
k
k
k
k
k
k
T
T
a
T
T
k
k
k
k
T
T
a
a
a
"}
(40,1,1) = {"
a
a
a
a
a
a
a
a
a
a
a
a
a
a
a
a
a
a
a
a
a
a
a
a
a
a
a
a
a
a
T
T
k
T
T
T
T
a
T
k
k
k
k
k
k
k
k
k
T
a
T
T
T
T
k
T
T
T
a
a
a
"}
(41,1,1) = {"
a
a
a
a
a
a
a
a
a
a
a
a
a
a
a
a
a
a
a
a
a
a
a
a
a
a
a
a
a
a
T
k
k
k
k
k
k
k
k
k
k
k
k
k
k
k
k
k
k
k
k
k
k
k
k
k
k
T
a
a
a
"}
(42,1,1) = {"
a
a
a
a
a
a
a
a
a
a
a
a
a
a
a
a
a
a
a
a
a
a
a
a
a
a
a
a
a
a
T
T
T
k
T
T
T
a
T
k
k
k
k
k
k
k
k
k
T
a
T
k
k
k
k
k
k
T
a
a
a
"}
(43,1,1) = {"
a
a
a
a
a
a
a
a
a
a
a
a
a
a
a
a
a
a
a
a
a
a
a
a
a
a
a
a
a
a
T
k
k
k
k
T
T
a
T
T
k
k
k
k
k
k
k
T
T
a
T
T
k
k
k
k
T
T
a
a
a
"}
(44,1,1) = {"
a
a
a
a
a
a
a
a
a
a
a
a
a
a
a
a
a
a
a
a
a
a
a
a
a
a
a
a
a
a
T
k
k
k
k
T
a
a
a
T
k
k
k
k
k
k
k
T
a
a
a
T
k
k
k
k
T
a
a
a
a
"}
(45,1,1) = {"
a
a
a
a
a
a
a
a
a
a
a
a
a
a
a
a
a
a
a
a
a
a
a
a
a
a
a
a
a
a
T
k
k
T
T
T
a
a
a
T
T
T
k
k
k
T
T
T
a
a
a
T
k
k
k
k
T
a
a
a
a
"}
(46,1,1) = {"
a
a
a
a
a
a
a
a
a
a
a
a
a
a
a
a
a
a
a
a
a
a
a
a
a
a
a
a
a
a
T
T
T
T
a
a
a
a
a
a
a
T
N
N
N
T
a
a
a
a
a
T
T
T
T
T
T
a
a
a
a
"}
(47,1,1) = {"
a
a
a
a
a
a
a
a
a
a
a
a
a
a
a
a
a
a
a
a
a
a
a
a
a
a
a
a
a
a
a
a
a
a
a
a
a
a
a
a
a
a
a
a
a
a
a
a
a
a
a
a
a
a
a
a
a
a
a
a
a
"}
(48,1,1) = {"
a
a
a
a
a
a
a
a
a
a
a
a
a
a
a
a
a
a
a
a
a
a
a
a
a
a
a
a
a
a
a
a
a
a
a
a
a
a
a
a
a
a
a
a
a
a
a
a
a
a
a
a
a
a
a
a
a
a
a
a
a
"}
(49,1,1) = {"
a
a
a
a
a
a
a
a
a
a
a
a
a
a
a
a
a
a
a
a
a
a
a
a
a
a
a
a
a
a
a
a
a
a
a
a
a
a
a
a
a
a
a
a
a
a
a
a
a
a
a
a
a
a
a
a
a
a
a
a
a
"}
(50,1,1) = {"
a
a
a
a
a
a
a
a
a
a
a
a
a
a
a
a
a
a
a
a
a
a
a
a
a
a
a
a
a
a
a
a
a
a
a
a
a
a
a
a
a
a
a
a
a
a
a
a
a
a
a
a
a
a
a
a
a
a
a
a
a
"}
(51,1,1) = {"
a
a
a
a
a
a
a
a
a
a
a
a
a
a
a
a
a
a
a
a
a
a
a
a
a
a
a
a
a
a
a
a
a
a
a
a
a
a
a
a
a
a
a
a
a
a
a
a
a
a
a
a
a
a
a
a
a
a
a
a
a
"}
(52,1,1) = {"
a
a
a
a
a
a
a
a
a
a
a
a
a
a
a
a
a
a
a
a
a
a
a
a
a
a
a
a
a
a
a
a
a
a
a
a
a
a
a
a
a
a
a
a
a
a
a
a
a
a
a
a
a
a
a
a
a
a
a
a
a
"}
(53,1,1) = {"
a
a
a
a
a
a
a
a
a
a
a
a
a
a
a
a
a
a
a
a
a
a
a
a
a
a
a
a
a
a
a
a
a
a
a
a
a
a
a
a
a
a
a
a
a
a
a
a
a
a
a
a
a
a
a
a
a
a
a
a
a
"}
(54,1,1) = {"
a
a
a
a
a
a
a
a
a
a
a
a
a
a
a
a
a
a
a
a
a
a
a
a
a
a
a
a
a
a
a
a
a
a
a
a
a
a
a
a
a
a
a
a
a
a
a
a
a
a
a
a
a
a
a
a
a
a
a
a
a
"}
(55,1,1) = {"
a
a
a
a
a
a
a
a
a
a
a
a
a
a
a
a
a
a
a
a
a
a
a
a
a
a
a
a
a
a
a
a
a
a
a
a
a
a
a
a
a
a
a
a
a
a
a
a
a
a
a
a
a
a
a
a
a
a
a
a
a
"}
(56,1,1) = {"
a
a
a
a
a
a
a
a
a
a
a
a
a
a
a
a
a
a
a
a
a
a
a
a
a
a
a
a
a
a
a
a
a
a
a
a
a
a
a
a
a
a
a
a
a
a
a
a
a
a
a
a
a
a
a
a
a
a
a
a
a
"}
(57,1,1) = {"
a
a
a
a
a
a
a
a
a
a
a
a
a
a
a
a
a
a
a
a
a
a
a
a
a
a
a
a
a
a
a
a
a
a
a
a
a
a
a
a
a
a
a
a
a
a
a
a
a
a
a
a
a
a
a
a
a
a
a
a
a
"}
(58,1,1) = {"
a
a
a
a
a
a
a
a
a
a
a
a
a
a
a
a
a
a
a
a
a
a
a
a
a
a
a
a
a
a
a
a
a
a
a
a
a
a
a
a
a
a
a
a
a
a
a
a
a
a
a
a
a
a
a
a
a
a
a
a
a
"}
(59,1,1) = {"
a
a
a
a
a
a
a
a
a
a
a
a
a
a
a
a
a
a
a
a
a
a
a
a
a
a
a
a
a
a
a
a
a
a
a
a
a
a
a
a
a
a
a
a
a
a
a
a
a
a
a
a
a
a
a
a
a
a
a
a
a
"}
(60,1,1) = {"
a
a
a
a
a
a
a
a
a
a
a
a
a
a
a
a
a
a
a
a
a
a
a
a
a
a
a
a
a
a
a
a
a
a
a
a
a
a
a
a
a
a
a
a
a
a
a
a
a
a
a
a
a
a
a
a
a
a
a
a
a
"}
(61,1,1) = {"
a
a
a
a
a
a
a
a
a
a
a
a
a
a
a
a
a
a
a
a
a
a
a
a
a
a
a
a
a
a
a
a
a
a
a
a
a
a
a
a
a
a
a
a
a
a
a
a
a
a
a
a
a
a
a
a
a
a
a
a
a
"}
